NO images/North.xpm
SO images/South.xpm
WE
EA images/East.xpm

F 200,100,0
C 225,30,0


        1111111111111111111111111
        1000000000110000000000001
        1011000001110000000000001
        1001000000000000000000001
111111111011000001110000000000001
100000000011000001110111111111111
1111011111111101110000001000111111
1111011111111101110101001000110001
1100000011010101110000001000100001
1000000000000000110000001000110001
1000000000W00000110101001000111111
110000011101010111110111100111
11110111 1110101 101111010001
11111111 1111111 111111111111
